1111111111111111111111111
1031110000222000000111001
1000011100030000021100001
1003000111000011220000001
1000000001122122000300001
1040000000000000000000001
1000111000220000001110001
1330000111220001110000001
1000000111200001110000001
1000020030002220000000001
1222220002211100000000301
1002222011100011100000001
1000011100001100001110001
1000011100001100001110001
1011100001111111100001111
1000111000033000011100001
1000001110000001110000001
1000001110220001110000001
1000111000222000011100001
1222222200000000000000001
1221110000033000001110001
1022200000000000000000001
1300001111111111110000001
1000000000000000000000001
1111111111111111111111111