1000000000
1010000000
1100000000
1000000000
1000000000
1000000000
1000000000
1000000000
1000000000
0000000000