1111111111111111111111111
1001110000000000000111001
1000011100000000011100001
1000000111000011100000001
1000000001111110000000001
1000001110000001110000001
1000111000000000001110001
1000000111000001110000001
1000000111000001110000001
1000000000000000000000001
1000000000011100000000001
1000000011100011100000001
1000011100001100001110001
1000011100001100001110001
1011100001111111100001111
1000111000000000011100001
1000001110000001110000001
1000001110000001110000001
1000111000000000011100001
1000000000000000000000001
1001110000000000001110001
1000000000000000000000001
1000001111111111110000001
1000000000000000000000001
1111111111111111111111111