1111111111111111111111111
1222220000000400000000001
1012101010101010101010101
1222000000022222220000001
1010101010101010101010101
1002202000022220002222001
1010101010101210101010101
1002200022220200002220001
1012101010101210101010101
1002000000000200000000001
1010101010101210101010101
1020220003000200000300001
1010101010101210101010101
1020000000000200222000001
1010101010101010101010101
1202220000000000000000001
1012121010101010101010101
1200222000000222222000001
1010101010101010101010101
1000022200000202200000001
1010101010101210101010101
1000222000000022222200001
1010101010101210101010101
1000030000000000000300001
1111111111111111111111111