1111111111111111111111111
1000000000000000000000001
1010101010101010101010101
1000000000000000000000001
1010101010101010101010101
1000000000000020000000001
1010101010101010101010101
1000000000000000000000001
1010101010101010101010101
1000000000000000000000001
1010101010101010101010101
1000000000000000000000001
1010101010101010101010101
1000000000000020000000001
1010101010101010101010101
1020000000000000000000001
1010101010101010101010101
1000000000000000000000001
1010101010101010101010101
1000000000000000000000001
1010101010101010101010101
1000000000000020000000001
1010101010101010101010101
1111111111111111111111111