0001110001
1001110011
0110001110
0011100011
0110101001
0101122011
0101001101
0101001100
2001010001