01001111000001110010
11100000101010001010
01010100011000111101
01010100011000110100
00001111000011110001
11000000111000011010
00011100120101010001
00001110001111100010
00001111100100001110