0001110001
1001110011
0110001110
0011100011
0110101001
0101100011
0101001101
0101001100
0001010001