1111111111
1000000001
1222220001
1000000001
1000000001
1030004001
1000000001
1030000001
1000000001
1111111111